##############
# # # ###  #B#
# # #   # ## #
#   # #   ## #
## ## # # ## #
##    # #    #
#### ## ######
#A   ##      #
##############