%          B
% %%%%%%%%%
% %       %
% % %%%%% %
%   %     %
%%% % %%%%%
A   %