#################
#         #     #
# ######### ### #
A #           # #
# # ######### # #
# # #   #   # # #
# #   # # # ### #
# ### # # # # # #
# # # # # #   # #
# # ###   # # # #
# # # ### # # # #
# # #       # # #
# # ######### # #
# #           # B
# ### ######### #
#       #       #
#################