###########################
A               #     #   #
# ########### # # # # # # #
# #     # #   # # # #   # #
# # # ### # ##### # ##### #
# # #   # #       #     # #
# # ### # ########### # ###
# # # # #           # #   #
# # # # ########### ##### #
# # # #     #     #     # #
# # # ### ### # ####### # #
# #     #     #     #   # #
# ################# # ### #
#               #   # #   #
############### # ### # ###
#       #       # #   #   #
# # ### # ####### # ##### #
# #   # # #       #     # #
# ### ### # ##### ##### # #
#   #   # #   #   #     # #
####### # # ### # # ##### #
#       # # #   # # #     #
# ####### # # ### # ##### #
#   #     # #   # #       #
# # # ######### # #########
# #             #         B
###########################