#############A#######
#             #     #
# # ### ####### # # #
# # #   #       # # #
# # ##### ####### # #
# #     #   #   # # #
####### ### # ### ###
#         # #   #   #
# # ####### # # ### #
# # #       # # #   #
# ### ######### # # #
#   #           # # #
# # ### ######### # #
# #   # #       # # #
### # # # ##### # ###
#   # # # #   # #   #
# ##### # # ### ### #
#       # # #   #   #
# ####### # # ### # #
#   #     #       # #
#####B###############