##A################
#  #   #    #     #
# ## # # ## # ### #
#    #    # # #   #
######### # # # ###
#       # #   #   #
# ##### ####### # #
# #   #       # # #
# ###   ##### ### #
#   ##### #       #
# #    #    ##### #
# #### ######   # #
#   #  #   #  # # #
### # ## # # ## ###
#   #    # #  #   B
# ######## ## ### #
# #         # #   #
# # ######### #####
# #               #
###################