#########B###########
#       #         # #
# ##### ######### # #
# #   # #   #   # # #
# # # ### # # ### # #
# # #     # # #   # #
# # ##### # # # ### #
#   #     #   # #   #
# ### ### ##### # ###
#   # # #       #   #
### # # ########### #
#   # #   #       # #
# ### # # # ##### # #
# #   # #   #   #   #
# # ######### # ### #
# # #         # #   #
# # # # ######### ###
# #   #           # #
# # ######## ###### #
# #        #        #
##########A##########